9
3 3
3 4
32 32 32 0 32 32 0 32 0 
0 0 0 32 0 32 0 32 0 
0 0 32 0 0 32 32 0 0 
0 0 0 88 32 32 32 0 0 
0 32 0 32 32 0 32 0 32 
32 32 32 0 32 32 32 32 32 
32 0 32 32 32 32 32 0 0 
0 0 0 32 32 0 0 0 32 
32 0 32 0 32 32 0 32 0 
